A.Pavlyuchenkova	Pavlyuchenkova A.	
Karolina Pliskova	Pliskova Ka.	
Silvia Soler-Espinosa	Soler Espinosa S.	
Alison Van Uytvanck	Van Uytvanck A.	
Kimiko Date-Krumm	Date Krumm K.	
B.Zahlavova Strycova	Zahlavova Strycova B.	
Kai-Chen Chang	Chang K.C.	
Mirjana Lucic-Baroni	Lucic M.	
Maria Torro-Flor	Torro Flor M.T.	
An-Sophie Mestach	Mestach A.S.	
Ying-Ying Duan	Duan Y.Y.	
Anna-Lena Friedsam	Friedsam A.L.	
Carla Suarez Navarro	Suarez Navarro C.	
Arina Rodionova	Rodionova Ar.	
Pablo Carreno Busta	Carreno-Busta P.	
Alexandr Dolgopolov	Dolgopolov O.	Fix
Victor Estrella Burgos	Estrella Burgos V.	
Paul-Henri Mathieu	Mathieu P.H.	
Kenny De Schepper	De Schepper K.	
Jan-Lennard Struff	Struff J.L.	
Yen-Hsun Lu	Lu Y.H.	
Jo-Wilfried Tsonga	Tsonga J.W.	
Pierre-Hugues Herbert	Herbert P.H.	
Mariana Duque-Marino	Duque Marino M.	
Lourdes Dominguez Lino	Dominguez Lino L.	
A.Schmiedlova	Schmiedlova A.	
